R 1020 580
NO ./images/eagle.xpm
SO ./images/redbrick.xpm
WE ./images/bluestone.xpm
EA ./images/greystone.xpm

S ./images/barrel.xpm
F 128,128,128
C 0,255,255

 11111111111111111111111111111111111111
1000000000110000000000000000011111111111
10110000011101111110000010001
10010000000000000000000010001
11110000000000000000000000111
10000000000000000002011110011
1111000000000E000000200010001
11110100000000000002010010001
11000000111111011100000010001
100000001    10001100000010001
10000000011110001101010010001
11000000110101011111011110001
11110111111101011111011110001
11111111111111111111111111111
